  #####
###   #
#/+O  #
### O/#
#/##O #
# # / ##
#O ØOO/#
#   /  #
########
