##########
#    Ø # #
#  + #   #
#   O /  #
# ##     #
##########
